al : Albania
dz : Algeria
ao : Angola
ai : Anguilla
ag : Antigua and Barbuda
ar : Argentina
am : Armenia
au : Australia
at : Austria
az : Azerbaijan
bs : Bahamas
bh : Bahrain
bb : Barbados
by : Belarus
be : Belgium
bz : Belize
bj : Benin
bm : Bermuda
bt : Bhutan
bo : Bolivia
bw : Botswana
br : Brazil
vg : British Virgin Islands
bn : Brunei Darussalam
bg : Bulgaria
bf : Burkina Faso
kh : Cambodia
ca : Canada
cv : Cape Verde
ky : Cayman Islands
td : Chad
cl : Chile
cn : China
co : Colombia
cg : Congo Republic of the
cr : Costa Rica
hr : Croatia
cy : Cyprus
cz : Czech Republic
dk : Denmark
dm : Dominica
do : Dominican Republic
ec : Ecuador
eg : Egypt
sv : El Salvador
ee : Estonia
fj : Fiji
fi : Finland
fr : France
gm : Gambia
de : Germany
gh : Ghana
gr : Greece
gd : Grenada
gt : Guatemala
gw : Guinea-Bissau
gy : Guyana
hn : Honduras
hk : Hong Kong
hu : Hungary
is : Iceland
in : India
id : Indonesia
ie : Ireland
il : Israel
it : Italy
jm : Jamaica
jp : Japan
jo : Jordan
kz : Kazakhstan
ke : Kenya
kr : Korea Republic Of
kw : Kuwait
kg : Kyrgyzstan
la : Lao People's Democratic Republic
lv : Latvia
lb : Lebanon
lr : Liberia
li : Liechtenstein
lt : Lithuania
lu : Luxembourg
mo : Macau
mk : Macedonia
mg : Madagascar
mw : Malawi
my : Malaysia
ml : Mali
mt : Malta
mr : Mauritania
mu : Mauritius
mx : Mexico
fm : Micronesia Federated States of
md : Moldova
mn : Mongolia
me : Montenegro
ms : Montserrat
mz : Mozambique
na : Namibia
np : Nepal
nl : Netherlands
nz : New Zealand
ni : Nicaragua
ne : Niger
ng : Nigeria
no : Norway
om : Oman
pk : Pakistan
pw : Palau
pa : Panama
pg : Papua New Guinea
py : Paraguay
pe : Peru
ph : Philippines
pl : Poland
pt : Portugal
qa : Qatar
ro : Romania
ru : Russia
st : São Tomé and Príncipe
sa : Saudi Arabia
sn : Senegal
sc : Seychelles
sl : Sierra Leone
sg : Singapore
sk : Slovakia
si : Slovenia
sb : Solomon Islands
za : South Africa
es : Spain
lk : Sri Lanka
kn : St. Kitts and Nevis
lc : St. Lucia
vc : St. Vincent and The Grenadines
sr : Suriname
sz : Swaziland
se : Sweden
ch : Switzerland
tw : Taiwan
tj : Tajikistan
tz : Tanzania
th : Thailand
tt : Trinidad and Tobago
tn : Tunisia
tr : Turkey
tm : Turkmenistan
tc : Turks and Caicos
ug : Uganda
ua : Ukraine
ae : United Arab Emirates
gb : United Kingdom
us : United States
uy : Uruguay
uz : Uzbekistan
ve : Venezuela
vn : Vietnam
ye : Yemen
zw : Zimbabwe